30
15
##############################
##############################
##############################
##############################
##############################
############G.....G###########
#..................###########
5..............C...###########
#..................###########
############G.....G###########
##############################
##############################
##############################
##############################
##############################