30
15
##############################
#G....................########
#.....................########
#..O..................########
#............................#
#............................#
#........................F...#
#........................O...4
#........................F...#
#............................#
#............................#
#..O..................########
#.....................########
#G....................########
###############2##############
3