30
15
###############2##############
#...........................G#
#.F.#########................#
#...#########................#
#...#########................#
#...#########................#
#........................O...#
#........................F...6
#........................O...#
#...#########................#
#...#########................#
#...#########................#
#.F.#########................#
#...........................G#
###############################
5