30
15
##############################
#G....................########
#.....................########
#..O..................########
#............................#
#............................#
#........................O...#
#........................O...4
#........................O...#
#............................#
#............................#
#..O..................########
#.....................########
#G....................########
##############2###############