30
15
##############################
#G..........................G#
#............................#
#...########......########...#
#...########......########...#
#...########......########...#
#............................#
#P..........O..........O.....2
#............................#
#...########......########...#
#...########......########...#
#...########......########...#
#............................#
#G..........................G#
##############################