30
15
##############################
##############################
##############################
##############################
##############################
##############################
#...............G.############
3...............KG############
#...............G.############
##############################
##############################
##############################
##############################
##############################
##############################