30
15
###############2##############
#...........................G#
#.F.#########................#
#...#########................#
#...#########................#
#...#########................#
#........................F...#
#........................F...6
#........................F...#
#...#########................#
#...#########................#
#...#########................#
#.F.#########................#
#...........................G#
##############################