30
15
###############3##############
#############.....############
#############.....############
#############..F..############
#############.....############
#############.....############
#.................############
1.................############
#.................############
#############.....############
#############.....############
#############..F..############
#############.....############
#############.....############
###############5##############