30
15
###############3##############
#############*****############
#############*****############
#############*****############
#############*****############
#############*****############
#*****************############
1*****************############
#*****************############
#############*****############
#############*****############
#############*****############
#############*****############
#############*****############
###############5##############
2