30
15
##############################
#E**************************E#
#****************************#
#***########******########***#
#***########******########***#
#***########******########***#
#****************************#
#****************************2
#****************************#
#***########******########***#
#***########******########***#
#***########******########***#
#****************************#
#E**************************E#
##############################
1